fd	days	Annual number of days when TN < 0 degC
fd2	days	Annual number of days when TN < 2 degC
fdm2	days	Annual number of days when TN < -2 degC
fdm20	days	Annual number of days when TN < -20 degC
id	days	Annual number of days when TX < 0 degC
su	days	Annual number of days when TX > 25 degC
tr	days	Annual number of days when TN > 20 degC
gsl	days	Annual number of days between the first occurrence of 6 consecutive days with TM > 5 degC and the first occurrence of 6 consecutive days with TM < 5 degC
txx	degC	Warmest daily TX
tnn	degC	Coldest daily TN
tnx	degC	Warmest daily TN
txn	degC	Coldest daily TX
dtr	degC	Mean difference between daily TX and daily TN
wsdi	days	Annual number of days with at least 6 consecutive days when TX > 90th percentile
wsdin	days	Annual number of days with at least n consecutive days when TX > 90th percentile
csdi	days	Annual number of days with at least 6 consecutive days when TN < 10th percentile
csdin	days	Annual number of days with at least n consecutive days when TN < 10th percentile
tx50p	%	Percentage of days of days where TX > 50th percentile 
tx95t	degC	Value of 95th percentile of TX
tx10p	%	Percentage of days when TX < 10th percentile
tx90p	%	Percentage of days when TX > 90th percentile
tn10p	%	Percentage of days when TN < 10th percentile
tn90p	%	Percentage of days when TN > 90th percentile
tm5a	days	Annual number of days when TM >= 5 degC
tm5b	days	Annual number of days when TM < 5 degC
tm10a	days	Annual number of days when TM >= 10 degC
tm10b	days	Annual number of days when TM < 10 degC
su30	days	Annual number of days when TX >= 30 degC
su35	days	Annual number of days when TX >= 35 degC
hddheat	degC	Annual sum of Tb - TM (where Tb is a user-defined location-specific base temperature and TM < Tb)
cddcold	degC	Annual sum of TM - Tb (where Tb is a user-defined location-specific base temperature and TM > Tb)
gddgrow	degC	Annual sum of TM - Tb (where Tb is a user-defined location-specific base temperature and TM > Tb)
cdd	days	Maximum annual number of consecutive dry days (when precipitation < 1.0 mm)
cwd	days	Maximum annual number of consecutive wet days (when precipitation >= 1.0 mm)
r10mm	days	Annual number of days when precipitation >= 10 mm
r20mm	days	Annual number of days when precipitation >= 20 mm
rx1day	mm	Maximum 1-day precipitation total
rx5day	mm	Maximum 5-day precipitation total
prcptot	mm	Annual sum of daily precipitation >= 1.0 mm
sdii	mm/day	Annual total precipitation divided by the number of wet days (when total precipitation >= 1.0 mm)
r95p	mm	Annual sum of daily precipitation > 95th percentile
r99p	mm	Annual sum of daily precipitation > 99th percentile
r95ptot	%	100*r95p / PRCPTOT
r99ptot	%	100*r99p / PRCPTOT
rxnday	mm	Maximum n-day precipitation total
rnnmm	days	Annual number of days when precipitation >= n
ntxntn	events	Annual number of n consecutive days where both TX > 95th percentile and TN > 95th percentile, where 10 >= n >= 2
ntxbntnb	events	Annual number of n consecutive days where both TX < 5th percentile and TN < 5th percentile where 10 >= n >=2
hw	NA	Heat wave magnitude, amplitude, number, duration and frequency calculated for the three definitions of TX90, TN90 and EHF
spei	unitless	Standardised Precipitation Evapotranspiration Index. As implemented by the SPEI package in R
spi	unitless	Standardised Precipitation Index. As implemented by the SPEI package in R
